1111111111111111111
1000000000C00000C01
1P0000000000000C001
10000CCCC0000000001
1000000ECCC0000C001
1111111111111111111
