
1111111111111
10000011000C1
10000111110011000011111001
1P0000E000001
1000000000111
1111111111111
