11111111111
10000CC0001
1000CCCC001
1C000E00011
11100001111
11111101111
10000C000C1
1CCCCC00001
11101110111
11P01100C11
11111111111
